###########################################################
#@...#....................................................#
####.#....................................................#
#.........................................................#
#.........................................................#
#.........................................................#
#.........................................................#
#.........................................................#
#.........................................................#
#..................................................M......#
#.........................................................#
#.........................................................#
###########################################################